...........
.122222223.
.4#######4.
.4999999#4.
.49####9#4.
.49####9#4.
.49####9#4.
.49####9#4.
.49####9#4.
.49######4.
.766666665.
...........