............
............
............
............
............
....9999....
....9##9....
....9##9....
....9##9....
....9999....
............
............
............
............
............
............
