............
............
............
............
............
....####....
....#P##....
....####....
....##W#....
....####....
............
............
............
............
............
............
