.........
.1222223.
.8#####4.
.8#####4.
.8#####4.
.7666665.
.........