.........
.#######.
.#P#####.
.#######.
.....#W#.
.....###.
.........