..........
.########.
.######P#.
.########.
.########.
.######B#.
.#O######.
.####W#T#.
.########.
..........