........
.122223.
.4####8.
.9666#8.
.4####8.
.766665.
........