............
.##########.
.#P######W#.
.##########.
............