...........
.122222223.
.4#######4.
.4#######4.
.4#9#####4.
.4#####9#4.
.4#######4.
.4#######4.
.4####9##4.
.49######4.
.766666665.
...........