..........
.12222223.
.8######4.
.8######4.
.899999#4.
.89#####4.
.89#####4.
.8######4.
.76666665.
..........