..............
.122222222223.
.8##########4.
.766666666665.
..............