........
.######.
.#P####.
.######.
.#W####.
.######.
........