..........
.12222223.
.4######8.
.966666#8.
.4######8.
.76666665.
..........