.........
.#######.
.#P#####.
.###B###.
.#.....#.
.#######.
.#####W#.
.#######.
.........