............
.##########.
.#PAAAAAA##.
.##AAAAAA##.
.##########.
.######B###.
.##########.
.#######T##.
.##########.
.########W#.
.##########.
............