.........
.#######.
.#P##SW#.
.##S#S##.
.##S####.
.#######.
.........