..........
.########.
.#P#B##T#.
.########.
.######O#.
.##W#####.
.###B####.
.#T######.
.########.
..........