..........
.12222223.
.8######4.
.8#999994.
.8#9####4.
.8###99#4.
.8#99###4.
.8#9####4.
.76666665.
..........