..........
.########.
.#P######.
.########.
.#W######.
.########.
..........