.........
.#######.
.#P#####.
.##B####.
.#T##OW#.
.#######.
.........