............
.##########.
.#P########.
.##########.
.#W########.
.##########.
............