...........
.#########.
.#W#######.
.#P#######.
.#########.
.#########.
.#########.
.#########.
.#########.
.#########.
.#########.
...........