............
.##########.
.#P#SS###T#.
.###SS#B###.
.#W########.
.##########.
............