.........
.1222223.
.8#####4.
.76663#4.
.....8#4.
.....765.
.........