.........
.#######.
.#W###P#.
.#######.
.........