.........
.#######.
.#P###W#.
.##B####.
.#.....#.
.####B##.
.#######.
.#######.
.........