.........
.#######.
.#P###W#.
.#######.
.#T##B##.
.#######.
.........