............
.1222222223.
.8########4.
.8..######4.
.8##9999994.
.8########4.
.8########4.
.8........4.
.8########4.
.8#......#4.
.8########4.
.8########4.
.7666666665.
............