...........
.#########.
.#P#######.
.#########.
.##W######.
.#########.
.#########.
.#########.
.#########.
.#########.
.#########.
...........