..........
.12222223.
.4######8.
.72223##8.
.....8##8.
.....7665.
..........