..........
.########.
.#WP#####.
.######B#.
.....##T#.
.....####.
..........