.........
.#######.
.#PB####.
.#B#B###.
.#######.
.#BW####.
.##B####.
.#######.
.#######.
.#######.
.#######.
.........