.........
.1222223.
.8#####8.
.8#####8.
.8999#98.
.8##9#98.
.8####98.
.8#99#98.
.8##9##8.
.8#####8.
.7666665.
.........