..........
.########.
.#P######.
.######A#.
.....##W#.
.....####.
..........