............
.##########.
.########P#.
.#..####B##.
.##########.
.##########.
.#SBBBBBBS#.
.#........#.
.#TAAAAAA##.
.##......##.
.##B#####O#.
.########W#.
.##########.
............